unweighted maze

#########
#S     E#
#  ###  #
#       #
#########


###########
#S   #   E#
# # # # # #
# #     # #
# ##### # #
#       # #
###########



weighted maze

###########
#S   ~   E#
# # #~# # #
# #   ~ # #
# ##### # #
#     ~ # #
###########

###############
#S    ~~~~   E#
# # ####### # #
# #       ~ # #
# ####### # # #
#   ~~~~   #  #
###############
